TST = "countries/Test.txt"
QIN = "countries/Qingcheng.txt"
KOD = "countries/Kodeshia.txt"
MUR = "countries/Mursland.txt"
#HEL = "countries/Helinika.txt"
#POJ = "countries/Poja.txt"
TIP = "countries/Tiperyn.txt"
EUR = "counrties/Eureka.txt"
LUS = "countries/Lusjki.txt"
VRT = "countries/Vrtgora.txt"
SAM = "countries/Samotkhe.txt"
ANT = "countries/Antarrner.txt"
HVA = "counrties/Hvallica.txt"
TII = "countries/Tili state.txt"
IER = "countries/Iere.txt"
#TON = "countries/Tonkina.txt"
CHZ = "countries/Chezzetcook.txt"
AKI = "countries/Akiteiwa.txt"
AKN = "countries/Akiteiwa North.txt"
AKC = "countries/Akiteiwa WPF.txt"
AKW = "countries/Akiteiwa War.txt"
WAT = "countries/Wata Ame.txt"
LST = "countries/Lestykhol.txt"
#RAZ = "countries/United Provinces of Rovnoska and Zaporizhia.txt"
ZAP = "countries/Zaporizhia.txt"
ROV = "countries/Rovsnoska.txt"
GPR = "countries/Graznava.txt"
PER = "countries/Peremorovka.txt"
NSR = "countries/Northern Nasiria.txt"
#POZ = "countries/Pozrika.txt"
CHA = "countries/Chaldea.txt"
KHO = "countries/Khorasan.txt"
SVE = "countries/Sovena.txt"
MIH = "countries/Mihranestan.txt"
KTK = "countries/Kitoko.txt"
LEI = "countries/Leinzeberg.txt"
BEI = "countries/Beifang.txt"
HYD = "countries/Hydar.txt"
ASS = "countries/Aukalnia and Sartland.txt"
AUK = "countries/Aukalnia.txt"
SAR = "countries/Sartland.txt"
TLN = "countries/Tilenno.txt"
YAR = "countries/Yarova.txt"
KIR = "countries/Kironia.txt"
DES = "countries/Destland.txt"
SER = "countries/Seratof.txt"
BOR = "countries/Borgosesia.txt"
MCU = "countries/Mero-Curgovina.txt"
OSR = "countries/Osorra.txt"
PRO = "countries/Propygria.txt"
BAM = "countries/Baileneu Ma.txt"
VKA = "countries/Veikaia.txt"
KRW = "countries/Kurwistan.txt"
ABL = "countries/Albel.txt"
ALV = "countries/Alvakalia.txt"
NBA = "countries/North Boaga.txt"
SBA = "countries/South Boaga.txt"
SVX = "countries/Svenskt.txt" #SVE is in use by Sovena :(
QUR = "countries/Qurac.txt"
JUN = "countries/Jungastia.txt"
ABE = "countries/Abeille.txt"
ARO = "countries/Arroyo.txt"
TGN = "countries/Teigne.txt"
CIP = "countries/Cipertine.txt"
TRR = "countries/Terres Riveraines.txt"
TAV = "countries/Tavaluda.txt"
BDZ = "countries/Badzevalari.txt"
KNA = "countries/KNA.txt"
THY = "countries/Theyka.txt"
CER = "countries/Cervera.txt"
ZHV = "countries/Zahava.txt"
KYA = "countries/Kaya.txt"
SIW = "countries/SiWallqanqa.txt"
JIN = "countries/Jinhang.txt"
# SIN = "countries/Sinaya.txt"
# ARR = "countries/Arum.txt"
PUK = "countries/Pukara.txt"
HOS = "countries/Hosuman.txt"
SMA = "countries/Santa Magdalena.txt"
PRA = "countries/Prabhat.txt"
NAN = "countries/Nanling.txt"
SAT = "countries/Satamurta.txt"
#ALS = "countries/Alsahra.txt"
PAS = "countries/Paseiwa.txt"
AFT = "countries/Aftarestan.txt"
KSH = "countries/East Ramay.txt"
VYA = "countries/Vyama.txt"
HEI = "countries/Heiban.txt"
# ALE = "countries/Aleatory Land.txt"
xx1 = "countries/Something Chan.txt"
xx2 = "countries/Long Chile.txt"
#IOK = "countries/Iokuma.txt"
SEL = "countries/Selengeria.txt"
GAR = "countries/Gardarike.txt"
THU = "countries/Thuyiquakliq.txt"
STE = "countries/Sterndal.txt"
RIN = "countries/Ringerike.txt"
# EMB = "countries/Embrea.txt"
MES = "countries/Mespalia.txt"
MOD = "countries/Modrovia.txt"
AYG = "countries/Agrana y Griegro.txt"
AIR = "countries/Airgialla.txt"
TRA = "countries/Traxia.txt"
# LEG = "countries/Legantus.txt"
# VAL = "countries/Vallis.txt"
TEU = "countries/Teutonia.txt"
AUS = "countries/Austrasia.txt"
RAM = "countries/Ramay.txt"
OST = "countries/Ostboland.txt"
STY = "countries/Stylyflysa.txt"
VEL = "countries/Velselexo.txt"
ARB = "countries/Arbenz.txt"
ARG = "countries/Argata.txt"
NYL = "countries/Nyland.txt"
BRI = "countries/Brigantica.txt"
ALB = "countries/Albaterra.txt"
NVL = "countries/New Valentina.txt"
CAG = "countries/Cagayan.txt"
#KON = "countries/Konagher-Tsensawa.txt"
KAS = "countries/Kasibaar.txt"
#PAC = "countries/Pacharikcha.txt"